NO     ./assets/no.png
    SO    ./assets/so.png
WE ./assets/we.png
EA ./assets/ea.png

F 010,5,200
C 233,21,3





1111111111111111
1000000110000001
1001000000000001
1000000000010001
1000000000011111
100000000000000111
111000000000001
100000000001100111
1000000000000001
1001100000000001
1000000000110001
1000000000100001
10011110001000W1
1000000000100001
1000000000100001
1000000000100001
1000000000100001
1000000000100001
1000000000100001
1000000000100001
1000000000100001
1000000000100001
1000000000100001
1000000000100001
1000000000100001
1000000000100001
1111111111111111