NO     ./assets/no.png
    SO    ./assets/so.png
WE ./assets/we.png
EA ./assets/ea.png

F 010,5,200
C 35,21,3



11111111
10000001
1N111001
11100011
11101101
10001101
10110001
11111111