NO     ./assets/no.png
    SO    ./assets/so.png
WE ./assets/we.png
EA ./assets/ea.png

F 010,5,200
C 233,21,3



    11 1
111100W1
10000111
10111101
10001001
11010011
1000011
111111