NO assets/no.png
SO assets/so.png
EA assets/ea.png
WE assets/we.png
F 220,100,0
C 225,30,0
   
1111111111111111111111111111
1000000000000000000000000001
1001111111111111111111111101
1001                     101
1001      1111111111111  101
1001       000000000001  101
1001      1011111111101  101
1001      101       101  101
1001      101    111101  101
1001      101   1N00101  101
1001      101    110101  101
1001      101     10001  101
1001      101     11111  101
1001      101            101
1001      100111111111111101
1001      111111111111111111
1111