		 		 	 	 NO assets/WaterF2.png
										 SO assets/WaterF3.png
						EA assets/WaterF1.png
	WE assets/WaterF4.png
		F 39,245,232
					C 158,241,236

   
1111111111111111111111111111111111111111111
1000000110000000000000001110000000000000001
1001000000000000000001111111110000000110001
1000000000010000000000000000000000000000001
1000000000011110000001110000000001000001111
10000E0000000001000000100000000001111000001
1110000000000001100000111111111111111110001
1000001100011000000000001000000000000000001
1000000100000000000000001000000000111100001
1001100000000011111000001000000000000111001
1000000000110011000010000000111000000001111
1000000000000000000000000000000000000000001
1001111000100000011111111111000000100000001
1000001100011000001110000001100000000011001
1000000110000000000000000001110000111111001
1001110000000011111000001000011100011111001
1000000011111111110010001000111000010001111
1000000000000000000000000000000000000000001
1111111111100000011111111111000000000000011
1111111100000000000000001111000011111000011
1000000110000001111000001110000000111100001
1001100110000011111000001000001100000111001
1001100100110011000010000000111000000011111
1000000000110000000111101110001111100011001
1000000000000000000000000000000000000000001
1111111111111111111111111111111111111111111