NO     ./assets/no.png
    SO    ./assets/so.png
WE ./assets/we.png
EA ./assets/ea.png
F 220,100,0
C 225,30,0

11111
1W001
10001
10001
100E1
11111