NO     ./assets/no.png
    SO    ./assets/wall_1.png
WE ./assets/we.png
EA ./assets/ea.png

C 155,100,160
F 111,111,111

                      
11111111111111111
10000000000000001
1010000W000011111
10000000000000001
1111111111111111